"filename", "language", "C++", "Makefile", "Markdown", "comment", "blank", "total"
"c:\Users\xande\OneDrive\AAE-ICT\2de_jaar\OOP\eindProject1Oop2021\Makefile", "Makefile", 0, 53, 0, 16, 18, 87
"c:\Users\xande\OneDrive\AAE-ICT\2de_jaar\OOP\eindProject1Oop2021\README.md", "Markdown", 0, 0, 9, 0, 13, 22
"c:\Users\xande\OneDrive\AAE-ICT\2de_jaar\OOP\eindProject1Oop2021\src\action.cpp", "C++", 92, 0, 0, 1, 15, 108
"c:\Users\xande\OneDrive\AAE-ICT\2de_jaar\OOP\eindProject1Oop2021\src\article.cpp", "C++", 49, 0, 0, 3, 7, 59
"c:\Users\xande\OneDrive\AAE-ICT\2de_jaar\OOP\eindProject1Oop2021\src\company.cpp", "C++", 16, 0, 0, 0, 5, 21
"c:\Users\xande\OneDrive\AAE-ICT\2de_jaar\OOP\eindProject1Oop2021\src\customer.cpp", "C++", 20, 0, 0, 0, 6, 26
"c:\Users\xande\OneDrive\AAE-ICT\2de_jaar\OOP\eindProject1Oop2021\src\include\actions.h", "C++", 11, 0, 0, 1, 3, 15
"c:\Users\xande\OneDrive\AAE-ICT\2de_jaar\OOP\eindProject1Oop2021\src\include\article.h", "C++", 30, 0, 0, 0, 6, 36
"c:\Users\xande\OneDrive\AAE-ICT\2de_jaar\OOP\eindProject1Oop2021\src\include\company.h", "C++", 17, 0, 0, 0, 5, 22
"c:\Users\xande\OneDrive\AAE-ICT\2de_jaar\OOP\eindProject1Oop2021\src\include\customer.h", "C++", 18, 0, 0, 0, 3, 21
"c:\Users\xande\OneDrive\AAE-ICT\2de_jaar\OOP\eindProject1Oop2021\src\include\invoice.h", "C++", 24, 0, 0, 0, 15, 39
"c:\Users\xande\OneDrive\AAE-ICT\2de_jaar\OOP\eindProject1Oop2021\src\include\menu.h", "C++", 20, 0, 0, 0, 3, 23
"c:\Users\xande\OneDrive\AAE-ICT\2de_jaar\OOP\eindProject1Oop2021\src\include\rim.h", "C++", 24, 0, 0, 1, 8, 33
"c:\Users\xande\OneDrive\AAE-ICT\2de_jaar\OOP\eindProject1Oop2021\src\include\tire.h", "C++", 27, 0, 0, 0, 9, 36
"c:\Users\xande\OneDrive\AAE-ICT\2de_jaar\OOP\eindProject1Oop2021\src\include\tireCenter.h", "C++", 23, 0, 0, 0, 4, 27
"c:\Users\xande\OneDrive\AAE-ICT\2de_jaar\OOP\eindProject1Oop2021\src\include\user.h", "C++", 18, 0, 0, 0, 3, 21
"c:\Users\xande\OneDrive\AAE-ICT\2de_jaar\OOP\eindProject1Oop2021\src\invoice.cpp", "C++", 34, 0, 0, 2, 8, 44
"c:\Users\xande\OneDrive\AAE-ICT\2de_jaar\OOP\eindProject1Oop2021\src\main.cpp", "C++", 132, 0, 0, 1, 24, 157
"c:\Users\xande\OneDrive\AAE-ICT\2de_jaar\OOP\eindProject1Oop2021\src\menu.cpp", "C++", 77, 0, 0, 1, 13, 91
"c:\Users\xande\OneDrive\AAE-ICT\2de_jaar\OOP\eindProject1Oop2021\src\rim.cpp", "C++", 37, 0, 0, 1, 10, 48
"c:\Users\xande\OneDrive\AAE-ICT\2de_jaar\OOP\eindProject1Oop2021\src\tire.cpp", "C++", 43, 0, 0, 0, 10, 53
"c:\Users\xande\OneDrive\AAE-ICT\2de_jaar\OOP\eindProject1Oop2021\src\tireCenter.cpp", "C++", 29, 0, 0, 0, 9, 38
"c:\Users\xande\OneDrive\AAE-ICT\2de_jaar\OOP\eindProject1Oop2021\src\user.cpp", "C++", 25, 0, 0, 0, 11, 36
"Total", "-", 766, 53, 9, 27, 208, 1063